{
    "name": "自定义关卡 1",
    "layout": [
        "##########",
        "#@       #",
        "#   $    #",
        "#    .   #",
        "#        #",
        "##########"
    ],
    "difficulty": "简单",
    "par_moves": 20,
    "par_pushes": 10
}
