{
    "name": "自定义关卡 2",
    "layout": [
        "############",
        "#@         #",
        "#   $      #",
        "#    .     #",
        "#          #",
        "############"
    ],
    "difficulty": "中等",
    "par_moves": 30,
    "par_pushes": 15
}
