{
    "name": "移动逻辑测试",
    "difficulty": "测试",
    "layout": [
        "###############",
        "#   #   #     #",
        "# @ $   $  .  #", 
        "#   #   #  .  #",
        "#   $   #     #",
        "#   #   #     #",
        "###############"
    ],
    "par_moves": 40,
    "par_pushes": 16,
    "description": "全面测试推箱子游戏的移动逻辑"
}
