{
    "name": "复杂路径",
    "difficulty": "困难",
    "layout": [
        "#############",
        "#     #     #",
        "#   $ . .   #", 
        "# @  ###    #",
        "#   $ .   $ #",
        "#           #",
        "#############"
    ],
    "par_moves": 40,
    "par_pushes": 12,
    "description": "需要绕过障碍物移动箱子"
}
