{
    "name": "多箱子协同",
    "difficulty": "专家",
    "layout": [
        "##############",
        "#   #    #   #",
        "#      $ # @ #", 
        "#   #$ $ #   #",
        "# . . . .$   #",
        "##############"
    ],
    "par_moves": 50,
    "par_pushes": 15,
    "description": "需要精确协调多个箱子的移动"
}
